11111111111111111111
1PCCCCCCCCCCCCCCCCC1
1C111C1C11111C1111C1
1CCCCC1C1CEC1CCCCCC1
11111C1C11C11C1111C1
1CCCCC1CCCCCCCCCCCC1
1C111C1C111C1C1111C1
1C111C1C111C1C1111C1
1CCCCCCCCCCC1CCCCCC1
11111111111111111111